"filename", "language", "JavaScript", "JSON", "comment", "blank", "total"
"/Users/geoaeiou/Desktop/spectrum/api/apollo-server.js", "JavaScript", 135, 0, 8, 9, 152
"/Users/geoaeiou/Desktop/spectrum/api/authentication.js", "JavaScript", 348, 0, 27, 34, 409
"/Users/geoaeiou/Desktop/spectrum/api/index.js", "JavaScript", 83, 0, 14, 19, 116
"/Users/geoaeiou/Desktop/spectrum/api/loaders/channel.js", "JavaScript", 37, 0, 1, 8, 46
"/Users/geoaeiou/Desktop/spectrum/api/loaders/community.js", "JavaScript", 37, 0, 1, 8, 46
"/Users/geoaeiou/Desktop/spectrum/api/loaders/create-loader.js", "JavaScript", 30, 0, 9, 5, 44
"/Users/geoaeiou/Desktop/spectrum/api/loaders/directMessageThread.js", "JavaScript", 21, 0, 1, 5, 27
"/Users/geoaeiou/Desktop/spectrum/api/loaders/index.js", "JavaScript", 76, 0, 2, 3, 81
"/Users/geoaeiou/Desktop/spectrum/api/loaders/message.js", "JavaScript", 11, 0, 1, 3, 15
"/Users/geoaeiou/Desktop/spectrum/api/loaders/notification.js", "JavaScript", 11, 0, 0, 3, 14
"/Users/geoaeiou/Desktop/spectrum/api/loaders/reaction.js", "JavaScript", 14, 0, 1, 4, 19
"/Users/geoaeiou/Desktop/spectrum/api/loaders/thread.js", "JavaScript", 17, 0, 1, 4, 22
"/Users/geoaeiou/Desktop/spectrum/api/loaders/threadReaction.js", "JavaScript", 11, 0, 1, 3, 15
"/Users/geoaeiou/Desktop/spectrum/api/loaders/types.js", "JavaScript", 8, 0, 1, 3, 12
"/Users/geoaeiou/Desktop/spectrum/api/loaders/user.js", "JavaScript", 45, 0, 1, 9, 55
"/Users/geoaeiou/Desktop/spectrum/api/migrations/20170410074258-initial-data.js", "JavaScript", 339, 0, 15, 2, 356
"/Users/geoaeiou/Desktop/spectrum/api/migrations/20170613200350-notifications.js", "JavaScript", 205, 0, 5, 2, 212
"/Users/geoaeiou/Desktop/spectrum/api/migrations/20170616113103-compound-indexes-for-ordering.js", "JavaScript", 35, 0, 4, 2, 41
"/Users/geoaeiou/Desktop/spectrum/api/migrations/20170627104435-user-email-settings.js", "JavaScript", 46, 0, 3, 2, 51
"/Users/geoaeiou/Desktop/spectrum/api/migrations/20170701173337-linkify-messages.js", "JavaScript", 28, 0, 2, 3, 33
"/Users/geoaeiou/Desktop/spectrum/api/migrations/20170702194221-fix-images.js", "JavaScript", 31, 0, 3, 3, 37
"/Users/geoaeiou/Desktop/spectrum/api/migrations/20170706114239-providerfield-indexes.js", "JavaScript", 22, 0, 0, 2, 24
"/Users/geoaeiou/Desktop/spectrum/api/migrations/20170706205658-slack-import.js", "JavaScript", 34, 0, 0, 2, 36
"/Users/geoaeiou/Desktop/spectrum/api/migrations/20170714171920-web-push-subscription.js", "JavaScript", 28, 0, 0, 2, 30
"/Users/geoaeiou/Desktop/spectrum/api/migrations/20170724184557-notifications-entity-added-index.js", "JavaScript", 17, 0, 0, 2, 19
"/Users/geoaeiou/Desktop/spectrum/api/migrations/20170803104302-dedupe-users-settings.js", "JavaScript", 113, 0, 7, 3, 123
"/Users/geoaeiou/Desktop/spectrum/api/migrations/20170825220615-clean-recurring-payments.js", "JavaScript", 53, 0, 12, 3, 68
"/Users/geoaeiou/Desktop/spectrum/api/migrations/20170829233734-userid-index-on-invoices.js", "JavaScript", 14, 0, 0, 2, 16
"/Users/geoaeiou/Desktop/spectrum/api/migrations/20170831163211-invoice-data-model-update.js", "JavaScript", 50, 0, 4, 3, 57
"/Users/geoaeiou/Desktop/spectrum/api/migrations/20170907222544-digest-email-notification-settings.js", "JavaScript", 67, 0, 2, 2, 71
"/Users/geoaeiou/Desktop/spectrum/api/migrations/20170908230623-add-reputation-field-to-communities.js", "JavaScript", 44, 0, 1, 2, 47
"/Users/geoaeiou/Desktop/spectrum/api/migrations/20170912000619-backfill-rep.js", "JavaScript", 43, 0, 0, 4, 47
"/Users/geoaeiou/Desktop/spectrum/api/migrations/20170915201609-clean-up-bad-dm-data.js", "JavaScript", 21, 0, 0, 2, 23
"/Users/geoaeiou/Desktop/spectrum/api/migrations/20170926003025-activate-daily-weekly-digest-settings.js", "JavaScript", 22, 0, 0, 2, 24
"/Users/geoaeiou/Desktop/spectrum/api/migrations/20170926102527-speedy-gonzales.js", "JavaScript", 14, 0, 0, 2, 16
"/Users/geoaeiou/Desktop/spectrum/api/migrations/20170927002438-communityid-index-on-reputation-events.js", "JavaScript", 11, 0, 0, 2, 13
"/Users/geoaeiou/Desktop/spectrum/api/migrations/20170928143435-slate-to-draftjs.js.js", "JavaScript", 93, 0, 3, 14, 110
"/Users/geoaeiou/Desktop/spectrum/api/migrations/20171005075445-remove-markdown-links-from-messages.js", "JavaScript", 31, 0, 0, 4, 35
"/Users/geoaeiou/Desktop/spectrum/api/migrations/20171008101118-last-slate-to-draft.js", "JavaScript", 90, 0, 3, 14, 107
"/Users/geoaeiou/Desktop/spectrum/api/migrations/20171013195530-core-metrics-table.js", "JavaScript", 154, 0, 7, 9, 170
"/Users/geoaeiou/Desktop/spectrum/api/migrations/20171018235659-add-direst-message-user-settings.js", "JavaScript", 22, 0, 0, 2, 24
"/Users/geoaeiou/Desktop/spectrum/api/migrations/20171029090619-users-channels-index.js", "JavaScript", 12, 0, 0, 2, 14
"/Users/geoaeiou/Desktop/spectrum/api/migrations/20171029094352-users-threads-index.js", "JavaScript", 12, 0, 0, 2, 14
"/Users/geoaeiou/Desktop/spectrum/api/migrations/20171103014955-add-mention-notification-settings.js", "JavaScript", 19, 0, 0, 2, 21
"/Users/geoaeiou/Desktop/spectrum/api/migrations/20171129215512-index-communities-by-slug.js", "JavaScript", 11, 0, 0, 2, 13
"/Users/geoaeiou/Desktop/spectrum/api/migrations/20171129221050-curated-content-table-creation.js", "JavaScript", 130, 0, 0, 4, 134
"/Users/geoaeiou/Desktop/spectrum/api/migrations/20171208175038-index-users-for-search.js", "JavaScript", 26, 0, 2, 3, 31
"/Users/geoaeiou/Desktop/spectrum/api/migrations/20171208180800-index-communities-for-search.js", "JavaScript", 26, 0, 2, 3, 31
"/Users/geoaeiou/Desktop/spectrum/api/migrations/20171213002813-add-modified-at-field-to-users-and-communities.js", "JavaScript", 32, 0, 20, 2, 54
"/Users/geoaeiou/Desktop/spectrum/api/migrations/20180209015734-github-provider-id-index.js", "JavaScript", 14, 0, 0, 2, 16
"/Users/geoaeiou/Desktop/spectrum/api/migrations/20180214111357-expo-push-subscriptions.js", "JavaScript", 28, 0, 0, 2, 30
"/Users/geoaeiou/Desktop/spectrum/api/migrations/20180309144845-create-community-settings-table.js", "JavaScript", 18, 0, 0, 2, 20
"/Users/geoaeiou/Desktop/spectrum/api/migrations/20180316195507-create-channel-settings-table.js", "JavaScript", 18, 0, 0, 2, 20
"/Users/geoaeiou/Desktop/spectrum/api/migrations/20180320122000-create-stripe-tables.js", "JavaScript", 22, 0, 0, 3, 25
"/Users/geoaeiou/Desktop/spectrum/api/migrations/20180320173414-set-administrator-info-on-community.js", "JavaScript", 49, 0, 13, 5, 67
"/Users/geoaeiou/Desktop/spectrum/api/migrations/20180411183454-lowercase-all-the-slugs.js", "JavaScript", 26, 0, 0, 2, 28
"/Users/geoaeiou/Desktop/spectrum/api/migrations/20180428001543-reset-slack-import-records.js", "JavaScript", 13, 0, 0, 2, 15
"/Users/geoaeiou/Desktop/spectrum/api/migrations/20180504003702-encrypt-existing-slack-data.js", "JavaScript", 57, 0, 0, 11, 68
"/Users/geoaeiou/Desktop/spectrum/api/migrations/20180517180716-enable-private-communities.js", "JavaScript", 16, 0, 0, 2, 18
"/Users/geoaeiou/Desktop/spectrum/api/migrations/20180517215503-add-ispending-to-userscommunities.js", "JavaScript", 16, 0, 0, 2, 18
"/Users/geoaeiou/Desktop/spectrum/api/migrations/20180518135040-add-join-settings-to-community-settings.js", "JavaScript", 19, 0, 0, 2, 21
"/Users/geoaeiou/Desktop/spectrum/api/migrations/20180621001409-thread-likes-table.js", "JavaScript", 21, 0, 0, 2, 23
"/Users/geoaeiou/Desktop/spectrum/api/migrations/20180823115847-add-users-communities-indexes.js", "JavaScript", 60, 0, 0, 2, 62
"/Users/geoaeiou/Desktop/spectrum/api/migrations/20181001061156-thread-metadata-denormalization.js", "JavaScript", 56, 0, 0, 2, 58
"/Users/geoaeiou/Desktop/spectrum/api/migrations/20181001064151-fix-thread-metadata-message-counts.js", "JavaScript", 28, 0, 0, 2, 30
"/Users/geoaeiou/Desktop/spectrum/api/migrations/20181002060237-remove-payments.js", "JavaScript", 53, 0, 0, 5, 58
"/Users/geoaeiou/Desktop/spectrum/api/migrations/20181003233411-thread-reactions-useridandthreadid-index.js", "JavaScript", 12, 0, 0, 2, 14
"/Users/geoaeiou/Desktop/spectrum/api/migrations/20181004222636-denormalize-channel-community-member-counts.js", "JavaScript", 52, 0, 0, 1, 53
"/Users/geoaeiou/Desktop/spectrum/api/migrations/20181005143053-users-notifications-useridandnotificationid-index.js", "JavaScript", 15, 0, 0, 2, 17
"/Users/geoaeiou/Desktop/spectrum/api/migrations/20181005144259-users-notifications-userIdAndIsSeen-index.js", "JavaScript", 12, 0, 0, 2, 14
"/Users/geoaeiou/Desktop/spectrum/api/migrations/20181023160027-update-denormalized-member-counts.js", "JavaScript", 39, 0, 0, 1, 40
"/Users/geoaeiou/Desktop/spectrum/api/migrations/20181024173616-indexes-for-digests.js", "JavaScript", 30, 0, 0, 2, 32
"/Users/geoaeiou/Desktop/spectrum/api/migrations/20181027050052-remove-attachments-from-thread-model.js", "JavaScript", 13, 0, 0, 1, 14
"/Users/geoaeiou/Desktop/spectrum/api/migrations/20181102025454-fix-old-image-urls-in-messages.js", "JavaScript", 30, 0, 0, 4, 34
"/Users/geoaeiou/Desktop/spectrum/api/migrations/20181102040518-fix-old-image-urls-in-threads.js", "JavaScript", 58, 0, 0, 14, 72
"/Users/geoaeiou/Desktop/spectrum/api/migrations/20181102044407-fix-old-image-urls-in-communities.js", "JavaScript", 61, 0, 0, 13, 74
"/Users/geoaeiou/Desktop/spectrum/api/migrations/20181102045821-fix-old-image-urls-in-users.js", "JavaScript", 64, 0, 0, 13, 77
"/Users/geoaeiou/Desktop/spectrum/api/migrations/20181102054523-fix-aws-static-url-community-photos.js", "JavaScript", 46, 0, 0, 9, 55
"/Users/geoaeiou/Desktop/spectrum/api/migrations/20181116173949-add-terms-last-accepted-field-to-users.js", "JavaScript", 16, 0, 0, 2, 18
"/Users/geoaeiou/Desktop/spectrum/api/migrations/20181121054300-resync-community-member-counts.js", "JavaScript", 39, 0, 0, 1, 40
"/Users/geoaeiou/Desktop/spectrum/api/migrations/20181122162921-users-communities-useridandmember-index.js", "JavaScript", 12, 0, 0, 2, 14
"/Users/geoaeiou/Desktop/spectrum/api/migrations/20181126094455-users-channels-roles.js", "JavaScript", 57, 0, 0, 3, 60
"/Users/geoaeiou/Desktop/spectrum/api/migrations/20181127090014-communities-member-count-index.js", "JavaScript", 12, 0, 0, 2, 14
"/Users/geoaeiou/Desktop/spectrum/api/migrations/20181205171559-remove-old-users-notifications.js", "JavaScript", 50, 0, 0, 12, 62
"/Users/geoaeiou/Desktop/spectrum/api/migrations/20181211181146-add-usersthreads-user-id-and-participant-index.js", "JavaScript", 19, 0, 0, 1, 20
"/Users/geoaeiou/Desktop/spectrum/api/migrations/20190226085909-bot-user-sam.js", "JavaScript", 31, 0, 0, 1, 32
"/Users/geoaeiou/Desktop/spectrum/api/migrations/20190306125252-threads-watercooler-index.js", "JavaScript", 15, 0, 0, 2, 17
"/Users/geoaeiou/Desktop/spectrum/api/migrations/20190315142923-backfill-userscommunities-last-seen-community-last-active.js", "JavaScript", 58, 0, 0, 2, 60
"/Users/geoaeiou/Desktop/spectrum/api/migrations/20190327134509-delete-bot-messages.js", "JavaScript", 10, 0, 0, 2, 12
"/Users/geoaeiou/Desktop/spectrum/api/migrations/config.js", "JavaScript", 37, 0, 0, 9, 46
"/Users/geoaeiou/Desktop/spectrum/api/migrations/seed/default/channelSettings.js", "JavaScript", 17, 0, 0, 2, 19
"/Users/geoaeiou/Desktop/spectrum/api/migrations/seed/default/channels.js", "JavaScript", 146, 0, 1, 12, 159
"/Users/geoaeiou/Desktop/spectrum/api/migrations/seed/default/communities.js", "JavaScript", 97, 0, 1, 2, 100
"/Users/geoaeiou/Desktop/spectrum/api/migrations/seed/default/communitySettings.js", "JavaScript", 53, 0, 0, 2, 55
"/Users/geoaeiou/Desktop/spectrum/api/migrations/seed/default/constants.js", "JavaScript", 60, 0, 12, 5, 77
"/Users/geoaeiou/Desktop/spectrum/api/migrations/seed/default/directMessageThreads.js", "JavaScript", 16, 0, 1, 2, 19
"/Users/geoaeiou/Desktop/spectrum/api/migrations/seed/default/index.js", "JavaScript", 36, 0, 1, 2, 39
"/Users/geoaeiou/Desktop/spectrum/api/migrations/seed/default/messages.js", "JavaScript", 195, 0, 2, 4, 201
"/Users/geoaeiou/Desktop/spectrum/api/migrations/seed/default/notifications.js", "JavaScript", 32, 0, 1, 3, 36
"/Users/geoaeiou/Desktop/spectrum/api/migrations/seed/default/reactions.js", "JavaScript", 11, 0, 1, 2, 14
"/Users/geoaeiou/Desktop/spectrum/api/migrations/seed/default/threads.js", "JavaScript", 421, 0, 1, 6, 428
"/Users/geoaeiou/Desktop/spectrum/api/migrations/seed/default/users.js", "JavaScript", 159, 0, 1, 2, 162
"/Users/geoaeiou/Desktop/spectrum/api/migrations/seed/default/usersChannels.js", "JavaScript", 432, 0, 1, 6, 439
"/Users/geoaeiou/Desktop/spectrum/api/migrations/seed/default/usersCommunities.js", "JavaScript", 226, 0, 1, 6, 233
"/Users/geoaeiou/Desktop/spectrum/api/migrations/seed/default/usersDirectMessageThreads.js", "JavaScript", 49, 0, 1, 2, 52
"/Users/geoaeiou/Desktop/spectrum/api/migrations/seed/default/usersNotifications.js", "JavaScript", 13, 0, 1, 2, 16
"/Users/geoaeiou/Desktop/spectrum/api/migrations/seed/default/usersSettings.js", "JavaScript", 31, 0, 1, 2, 34
"/Users/geoaeiou/Desktop/spectrum/api/migrations/seed/default/usersThreads.js", "JavaScript", 76, 0, 1, 4, 81
"/Users/geoaeiou/Desktop/spectrum/api/migrations/seed/generate.js", "JavaScript", 230, 0, 20, 26, 276
"/Users/geoaeiou/Desktop/spectrum/api/migrations/seed/index.js", "JavaScript", 220, 0, 2, 19, 241
"/Users/geoaeiou/Desktop/spectrum/api/models/channel.js", "JavaScript", 373, 0, 63, 50, 486
"/Users/geoaeiou/Desktop/spectrum/api/models/channelSettings.js", "JavaScript", 140, 0, 4, 14, 158
"/Users/geoaeiou/Desktop/spectrum/api/models/community.js", "JavaScript", 640, 0, 54, 59, 753
"/Users/geoaeiou/Desktop/spectrum/api/models/communitySettings.js", "JavaScript", 340, 0, 11, 32, 383
"/Users/geoaeiou/Desktop/spectrum/api/models/curatedContent.js", "JavaScript", 11, 0, 2, 2, 15
"/Users/geoaeiou/Desktop/spectrum/api/models/directMessageThread.js", "JavaScript", 142, 0, 14, 16, 172
"/Users/geoaeiou/Desktop/spectrum/api/models/message.js", "JavaScript", 289, 0, 12, 31, 332
"/Users/geoaeiou/Desktop/spectrum/api/models/meta.js", "JavaScript", 22, 0, 10, 4, 36
"/Users/geoaeiou/Desktop/spectrum/api/models/notification.js", "JavaScript", 104, 0, 3, 11, 118
"/Users/geoaeiou/Desktop/spectrum/api/models/reaction.js", "JavaScript", 97, 0, 8, 14, 119
"/Users/geoaeiou/Desktop/spectrum/api/models/reputationEvents.js", "JavaScript", 27, 0, 2, 4, 33
"/Users/geoaeiou/Desktop/spectrum/api/models/search.js", "JavaScript", 117, 0, 9, 11, 137
"/Users/geoaeiou/Desktop/spectrum/api/models/session.js", "JavaScript", 8, 0, 1, 2, 11
"/Users/geoaeiou/Desktop/spectrum/api/models/slackImport.js", "JavaScript", 83, 0, 6, 7, 96
"/Users/geoaeiou/Desktop/spectrum/api/models/test/channel.test.js", "JavaScript", 154, 0, 1, 21, 176
"/Users/geoaeiou/Desktop/spectrum/api/models/thread.js", "JavaScript", 625, 0, 41, 68, 734
"/Users/geoaeiou/Desktop/spectrum/api/models/threadReaction.js", "JavaScript", 121, 0, 7, 16, 144
"/Users/geoaeiou/Desktop/spectrum/api/models/usersChannels.js", "JavaScript", 504, 0, 98, 56, 658
"/Users/geoaeiou/Desktop/spectrum/api/models/usersCommunities.js", "JavaScript", 512, 0, 65, 50, 627
"/Users/geoaeiou/Desktop/spectrum/api/models/usersDirectMessageThreads.js", "JavaScript", 102, 0, 31, 13, 146
"/Users/geoaeiou/Desktop/spectrum/api/models/usersSettings.js", "JavaScript", 99, 0, 3, 7, 109
"/Users/geoaeiou/Desktop/spectrum/api/models/usersThreads.js", "JavaScript", 139, 0, 25, 15, 179
"/Users/geoaeiou/Desktop/spectrum/api/models/utils.js", "JavaScript", 98, 0, 4, 12, 114
"/Users/geoaeiou/Desktop/spectrum/api/models/web-push-subscription.js", "JavaScript", 30, 0, 2, 4, 36
"/Users/geoaeiou/Desktop/spectrum/api/mutations/channel/archiveChannel.js", "JavaScript", 29, 0, 1, 8, 38
"/Users/geoaeiou/Desktop/spectrum/api/mutations/channel/createChannel.js", "JavaScript", 41, 0, 2, 9, 52
"/Users/geoaeiou/Desktop/spectrum/api/mutations/channel/deleteChannel.js", "JavaScript", 32, 0, 1, 9, 42
"/Users/geoaeiou/Desktop/spectrum/api/mutations/channel/disableChannelTokenJoin.js", "JavaScript", 25, 0, 1, 5, 31
"/Users/geoaeiou/Desktop/spectrum/api/mutations/channel/editChannel.js", "JavaScript", 22, 0, 1, 6, 29
"/Users/geoaeiou/Desktop/spectrum/api/mutations/channel/enableChannelTokenJoin.js", "JavaScript", 25, 0, 1, 5, 31
"/Users/geoaeiou/Desktop/spectrum/api/mutations/channel/index.js", "JavaScript", 32, 0, 1, 2, 35
"/Users/geoaeiou/Desktop/spectrum/api/mutations/channel/joinChannelWithToken.js", "JavaScript", 86, 0, 1, 14, 101
"/Users/geoaeiou/Desktop/spectrum/api/mutations/channel/resetChannelJoinToken.js", "JavaScript", 25, 0, 1, 5, 31
"/Users/geoaeiou/Desktop/spectrum/api/mutations/channel/restoreChannel.js", "JavaScript", 24, 0, 2, 7, 33
"/Users/geoaeiou/Desktop/spectrum/api/mutations/channel/toggleChannelNotifications.js", "JavaScript", 22, 0, 3, 7, 32
"/Users/geoaeiou/Desktop/spectrum/api/mutations/channel/toggleChannelSubscription.js", "JavaScript", 101, 0, 44, 17, 162
"/Users/geoaeiou/Desktop/spectrum/api/mutations/channel/togglePendingUser.js", "JavaScript", 68, 0, 4, 10, 82
"/Users/geoaeiou/Desktop/spectrum/api/mutations/channel/unblockUser.js", "JavaScript", 32, 0, 1, 7, 40
"/Users/geoaeiou/Desktop/spectrum/api/mutations/channel/updateChannelSlackBotLinks.js", "JavaScript", 25, 0, 1, 5, 31
"/Users/geoaeiou/Desktop/spectrum/api/mutations/community/createCommunity.js", "JavaScript", 74, 0, 11, 13, 98
"/Users/geoaeiou/Desktop/spectrum/api/mutations/community/deleteCommunity.js", "JavaScript", 48, 0, 5, 11, 64
"/Users/geoaeiou/Desktop/spectrum/api/mutations/community/disableBrandedLogin.js", "JavaScript", 29, 0, 2, 7, 38
"/Users/geoaeiou/Desktop/spectrum/api/mutations/community/disableCommunityTokenJoin.js", "JavaScript", 25, 0, 1, 5, 31
"/Users/geoaeiou/Desktop/spectrum/api/mutations/community/disableCommunityWatercooler.js", "JavaScript", 23, 0, 1, 7, 31
"/Users/geoaeiou/Desktop/spectrum/api/mutations/community/editCommunity.js", "JavaScript", 18, 0, 3, 4, 25
"/Users/geoaeiou/Desktop/spectrum/api/mutations/community/enableBrandedLogin.js", "JavaScript", 31, 0, 2, 7, 40
"/Users/geoaeiou/Desktop/spectrum/api/mutations/community/enableCommunityTokenJoin.js", "JavaScript", 25, 0, 1, 5, 31
"/Users/geoaeiou/Desktop/spectrum/api/mutations/community/enableCommunityWatercooler.js", "JavaScript", 46, 0, 1, 12, 59
"/Users/geoaeiou/Desktop/spectrum/api/mutations/community/importSlackMembers.js", "JavaScript", 33, 0, 7, 11, 51
"/Users/geoaeiou/Desktop/spectrum/api/mutations/community/index.js", "JavaScript", 44, 0, 1, 2, 47
"/Users/geoaeiou/Desktop/spectrum/api/mutations/community/pinThread.js", "JavaScript", 29, 0, 1, 9, 39
"/Users/geoaeiou/Desktop/spectrum/api/mutations/community/resetCommunityJoinToken.js", "JavaScript", 25, 0, 1, 5, 31
"/Users/geoaeiou/Desktop/spectrum/api/mutations/community/saveBrandedLoginSettings.js", "JavaScript", 37, 0, 2, 8, 47
"/Users/geoaeiou/Desktop/spectrum/api/mutations/community/sendEmailInvites.js", "JavaScript", 47, 0, 1, 6, 54
"/Users/geoaeiou/Desktop/spectrum/api/mutations/community/sendSlackInvites.js", "JavaScript", 45, 0, 1, 8, 54
"/Users/geoaeiou/Desktop/spectrum/api/mutations/community/setCommunityLastSeen.js", "JavaScript", 16, 0, 1, 3, 20
"/Users/geoaeiou/Desktop/spectrum/api/mutations/community/toggleCommunityMembership.js", "JavaScript", 66, 0, 22, 14, 102
"/Users/geoaeiou/Desktop/spectrum/api/mutations/community/toggleCommunityNoindex.js", "JavaScript", 25, 0, 1, 7, 33
"/Users/geoaeiou/Desktop/spectrum/api/mutations/community/toggleCommunityRedirect.js", "JavaScript", 25, 0, 1, 7, 33
"/Users/geoaeiou/Desktop/spectrum/api/mutations/community/updateAdministratorEmail.js", "JavaScript", 41, 0, 1, 6, 48
"/Users/geoaeiou/Desktop/spectrum/api/mutations/communityMember/addCommunityMember.js", "JavaScript", 55, 0, 6, 13, 74
"/Users/geoaeiou/Desktop/spectrum/api/mutations/communityMember/addCommunityMemberWithToken.js", "JavaScript", 66, 0, 1, 12, 79
"/Users/geoaeiou/Desktop/spectrum/api/mutations/communityMember/addCommunityMembers.js", "JavaScript", 52, 0, 2, 12, 66
"/Users/geoaeiou/Desktop/spectrum/api/mutations/communityMember/addCommunityModerator.js", "JavaScript", 59, 0, 7, 11, 77
"/Users/geoaeiou/Desktop/spectrum/api/mutations/communityMember/addPendingCommunityMember.js", "JavaScript", 68, 0, 4, 16, 88
"/Users/geoaeiou/Desktop/spectrum/api/mutations/communityMember/approvePendingCommunityMember.js", "JavaScript", 64, 0, 1, 12, 77
"/Users/geoaeiou/Desktop/spectrum/api/mutations/communityMember/blockCommunityMember.js", "JavaScript", 63, 0, 1, 13, 77
"/Users/geoaeiou/Desktop/spectrum/api/mutations/communityMember/blockPendingCommunityMember.js", "JavaScript", 63, 0, 1, 12, 76
"/Users/geoaeiou/Desktop/spectrum/api/mutations/communityMember/index.js", "JavaScript", 28, 0, 1, 2, 31
"/Users/geoaeiou/Desktop/spectrum/api/mutations/communityMember/removeCommunityMember.js", "JavaScript", 81, 0, 9, 16, 106
"/Users/geoaeiou/Desktop/spectrum/api/mutations/communityMember/removeCommunityModerator.js", "JavaScript", 65, 0, 7, 13, 85
"/Users/geoaeiou/Desktop/spectrum/api/mutations/communityMember/removePendingCommunityMember.js", "JavaScript", 30, 0, 2, 7, 39
"/Users/geoaeiou/Desktop/spectrum/api/mutations/communityMember/unblockCommunityMember.js", "JavaScript", 59, 0, 1, 11, 71
"/Users/geoaeiou/Desktop/spectrum/api/mutations/directMessageThread/createDirectMessageThread.js", "JavaScript", 76, 0, 13, 12, 101
"/Users/geoaeiou/Desktop/spectrum/api/mutations/directMessageThread/index.js", "JavaScript", 8, 0, 12, 4, 24
"/Users/geoaeiou/Desktop/spectrum/api/mutations/directMessageThread/setLastSeen.js", "JavaScript", 11, 0, 1, 4, 16
"/Users/geoaeiou/Desktop/spectrum/api/mutations/files/index.js", "JavaScript", 6, 0, 1, 2, 9
"/Users/geoaeiou/Desktop/spectrum/api/mutations/files/uploadImage.js", "JavaScript", 20, 0, 1, 3, 24
"/Users/geoaeiou/Desktop/spectrum/api/mutations/message/addMessage.js", "JavaScript", 235, 0, 15, 33, 283
"/Users/geoaeiou/Desktop/spectrum/api/mutations/message/deleteMessage.js", "JavaScript", 79, 0, 6, 14, 99
"/Users/geoaeiou/Desktop/spectrum/api/mutations/message/editMessage.js", "JavaScript", 62, 0, 1, 9, 72
"/Users/geoaeiou/Desktop/spectrum/api/mutations/message/index.js", "JavaScript", 10, 0, 1, 2, 13
"/Users/geoaeiou/Desktop/spectrum/api/mutations/meta/index.js", "JavaScript", 6, 0, 1, 2, 9
"/Users/geoaeiou/Desktop/spectrum/api/mutations/meta/saveUserCommunityPermissions.js", "JavaScript", 18, 0, 1, 2, 21
"/Users/geoaeiou/Desktop/spectrum/api/mutations/notification/index.js", "JavaScript", 10, 0, 1, 2, 13
"/Users/geoaeiou/Desktop/spectrum/api/mutations/notification/markAllNotificationsSeen.js", "JavaScript", 8, 0, 1, 2, 11
"/Users/geoaeiou/Desktop/spectrum/api/mutations/notification/markDirectMessageNotificationsSeen.js", "JavaScript", 8, 0, 1, 2, 11
"/Users/geoaeiou/Desktop/spectrum/api/mutations/notification/markSingleNotificationSeen.js", "JavaScript", 8, 0, 1, 2, 11
"/Users/geoaeiou/Desktop/spectrum/api/mutations/reaction/index.js", "JavaScript", 6, 0, 1, 2, 9
"/Users/geoaeiou/Desktop/spectrum/api/mutations/reaction/toggleReaction.js", "JavaScript", 12, 0, 1, 3, 16
"/Users/geoaeiou/Desktop/spectrum/api/mutations/thread/addThreadReaction.js", "JavaScript", 31, 0, 1, 5, 37
"/Users/geoaeiou/Desktop/spectrum/api/mutations/thread/deleteThread.js", "JavaScript", 45, 0, 7, 10, 62
"/Users/geoaeiou/Desktop/spectrum/api/mutations/thread/editThread.js", "JavaScript", 113, 0, 21, 26, 160
"/Users/geoaeiou/Desktop/spectrum/api/mutations/thread/index.js", "JavaScript", 20, 0, 1, 2, 23
"/Users/geoaeiou/Desktop/spectrum/api/mutations/thread/moveThread.js", "JavaScript", 57, 0, 3, 13, 73
"/Users/geoaeiou/Desktop/spectrum/api/mutations/thread/publishThread.js", "JavaScript", 243, 0, 20, 45, 308
"/Users/geoaeiou/Desktop/spectrum/api/mutations/thread/removeThreadReaction.js", "JavaScript", 36, 0, 1, 4, 41
"/Users/geoaeiou/Desktop/spectrum/api/mutations/thread/setThreadLock.js", "JavaScript", 48, 0, 8, 11, 67
"/Users/geoaeiou/Desktop/spectrum/api/mutations/thread/toggleThreadNotifications.js", "JavaScript", 39, 0, 6, 4, 49
"/Users/geoaeiou/Desktop/spectrum/api/mutations/user/banUser.js", "JavaScript", 40, 0, 1, 9, 50
"/Users/geoaeiou/Desktop/spectrum/api/mutations/user/deleteCurrentUser.js", "JavaScript", 20, 0, 1, 3, 24
"/Users/geoaeiou/Desktop/spectrum/api/mutations/user/editUser.js", "JavaScript", 58, 0, 5, 11, 74
"/Users/geoaeiou/Desktop/spectrum/api/mutations/user/index.js", "JavaScript", 27, 0, 1, 3, 31
"/Users/geoaeiou/Desktop/spectrum/api/mutations/user/reportUser.js", "JavaScript", 37, 0, 1, 7, 45
"/Users/geoaeiou/Desktop/spectrum/api/mutations/user/subscribeWebPush.js", "JavaScript", 34, 0, 1, 4, 39
"/Users/geoaeiou/Desktop/spectrum/api/mutations/user/toggleNotificationSettings.js", "JavaScript", 32, 0, 4, 7, 43
"/Users/geoaeiou/Desktop/spectrum/api/mutations/user/unsubscribeWebPush.js", "JavaScript", 10, 0, 1, 2, 13
"/Users/geoaeiou/Desktop/spectrum/api/mutations/user/updateUserEmail.js", "JavaScript", 33, 0, 1, 7, 41
"/Users/geoaeiou/Desktop/spectrum/api/package.json", "JSON", 0, 142, 0, 1, 143
"/Users/geoaeiou/Desktop/spectrum/api/queries/channel/blockedUsers.js", "JavaScript", 18, 0, 1, 3, 22
"/Users/geoaeiou/Desktop/spectrum/api/queries/channel/channelPermissions.js", "JavaScript", 25, 0, 1, 5, 31
"/Users/geoaeiou/Desktop/spectrum/api/queries/channel/community.js", "JavaScript", 16, 0, 1, 4, 21
"/Users/geoaeiou/Desktop/spectrum/api/queries/channel/communityPermissions.js", "JavaScript", 25, 0, 1, 4, 30
"/Users/geoaeiou/Desktop/spectrum/api/queries/channel/index.js", "JavaScript", 36, 0, 1, 3, 40
"/Users/geoaeiou/Desktop/spectrum/api/queries/channel/isArchived.js", "JavaScript", 5, 0, 1, 2, 8
"/Users/geoaeiou/Desktop/spectrum/api/queries/channel/joinSettings.js", "JavaScript", 13, 0, 1, 5, 19
"/Users/geoaeiou/Desktop/spectrum/api/queries/channel/memberConnection.js", "JavaScript", 32, 0, 3, 5, 40
"/Users/geoaeiou/Desktop/spectrum/api/queries/channel/memberCount.js", "JavaScript", 11, 0, 1, 4, 16
"/Users/geoaeiou/Desktop/spectrum/api/queries/channel/metaData.js", "JavaScript", 39, 0, 3, 8, 50
"/Users/geoaeiou/Desktop/spectrum/api/queries/channel/moderators.js", "JavaScript", 12, 0, 1, 4, 17
"/Users/geoaeiou/Desktop/spectrum/api/queries/channel/owners.js", "JavaScript", 12, 0, 1, 4, 17
"/Users/geoaeiou/Desktop/spectrum/api/queries/channel/pendingUsers.js", "JavaScript", 24, 0, 1, 3, 28
"/Users/geoaeiou/Desktop/spectrum/api/queries/channel/rootChannel.js", "JavaScript", 22, 0, 1, 4, 27
"/Users/geoaeiou/Desktop/spectrum/api/queries/channel/slackSettings.js", "JavaScript", 15, 0, 1, 3, 19
"/Users/geoaeiou/Desktop/spectrum/api/queries/channel/threadConnection.js", "JavaScript", 29, 0, 2, 4, 35
"/Users/geoaeiou/Desktop/spectrum/api/queries/channelSlackSettings/botLinks.js", "JavaScript", 9, 0, 1, 2, 12
"/Users/geoaeiou/Desktop/spectrum/api/queries/channelSlackSettings/index.js", "JavaScript", 6, 0, 1, 2, 9
"/Users/geoaeiou/Desktop/spectrum/api/queries/community/brandedLogin.js", "JavaScript", 12, 0, 1, 2, 15
"/Users/geoaeiou/Desktop/spectrum/api/queries/community/channelConnection.js", "JavaScript", 25, 0, 1, 4, 30
"/Users/geoaeiou/Desktop/spectrum/api/queries/community/communityPermissions.js", "JavaScript", 26, 0, 1, 6, 33
"/Users/geoaeiou/Desktop/spectrum/api/queries/community/contextPermissions.js", "JavaScript", 29, 0, 2, 5, 36
"/Users/geoaeiou/Desktop/spectrum/api/queries/community/conversationGrowth.js", "JavaScript", 40, 0, 1, 6, 47
"/Users/geoaeiou/Desktop/spectrum/api/queries/community/coverPhoto.js", "JavaScript", 7, 0, 1, 2, 10
"/Users/geoaeiou/Desktop/spectrum/api/queries/community/index.js", "JavaScript", 75, 0, 2, 6, 83
"/Users/geoaeiou/Desktop/spectrum/api/queries/community/joinSettings.js", "JavaScript", 13, 0, 1, 5, 19
"/Users/geoaeiou/Desktop/spectrum/api/queries/community/memberConnection.js", "JavaScript", 45, 0, 8, 8, 61
"/Users/geoaeiou/Desktop/spectrum/api/queries/community/memberGrowth.js", "JavaScript", 50, 0, 1, 5, 56
"/Users/geoaeiou/Desktop/spectrum/api/queries/community/members.js", "JavaScript", 69, 0, 3, 8, 80
"/Users/geoaeiou/Desktop/spectrum/api/queries/community/metaData.js", "JavaScript", 66, 0, 1, 17, 84
"/Users/geoaeiou/Desktop/spectrum/api/queries/community/pinnedThread.js", "JavaScript", 13, 0, 1, 5, 19
"/Users/geoaeiou/Desktop/spectrum/api/queries/community/profilePhoto.js", "JavaScript", 7, 0, 1, 2, 10
"/Users/geoaeiou/Desktop/spectrum/api/queries/community/rootCommunities.js", "JavaScript", 33, 0, 1, 6, 40
"/Users/geoaeiou/Desktop/spectrum/api/queries/community/rootCommunity.js", "JavaScript", 19, 0, 1, 6, 26
"/Users/geoaeiou/Desktop/spectrum/api/queries/community/rootRecentCommunities.js", "JavaScript", 2, 0, 1, 1, 4
"/Users/geoaeiou/Desktop/spectrum/api/queries/community/rootSearchCommunities.js", "JavaScript", 19, 0, 6, 3, 28
"/Users/geoaeiou/Desktop/spectrum/api/queries/community/rootSearchCommunityThreads.js", "JavaScript", 69, 0, 8, 11, 88
"/Users/geoaeiou/Desktop/spectrum/api/queries/community/rootTopCommunities.js", "JavaScript", 2, 0, 1, 1, 4
"/Users/geoaeiou/Desktop/spectrum/api/queries/community/slackImport.js", "JavaScript", 26, 0, 2, 4, 32
"/Users/geoaeiou/Desktop/spectrum/api/queries/community/slackSettings.js", "JavaScript", 15, 0, 1, 3, 19
"/Users/geoaeiou/Desktop/spectrum/api/queries/community/threadConnection.js", "JavaScript", 60, 0, 8, 8, 76
"/Users/geoaeiou/Desktop/spectrum/api/queries/community/topAndNewThreads.js", "JavaScript", 51, 0, 1, 10, 62
"/Users/geoaeiou/Desktop/spectrum/api/queries/community/topMembers.js", "JavaScript", 26, 0, 2, 7, 35
"/Users/geoaeiou/Desktop/spectrum/api/queries/community/watercooler.js", "JavaScript", 15, 0, 1, 4, 20
"/Users/geoaeiou/Desktop/spectrum/api/queries/communityMember/index.js", "JavaScript", 12, 0, 1, 2, 15
"/Users/geoaeiou/Desktop/spectrum/api/queries/communityMember/roles.js", "JavaScript", 14, 0, 1, 2, 17
"/Users/geoaeiou/Desktop/spectrum/api/queries/communityMember/rootCommunityMember.js", "JavaScript", 10, 0, 1, 3, 14
"/Users/geoaeiou/Desktop/spectrum/api/queries/communityMember/user.js", "JavaScript", 10, 0, 1, 2, 13
"/Users/geoaeiou/Desktop/spectrum/api/queries/communitySlackSettings/hasSentInvites.js", "JavaScript", 9, 0, 1, 2, 12
"/Users/geoaeiou/Desktop/spectrum/api/queries/communitySlackSettings/index.js", "JavaScript", 16, 0, 1, 2, 19
"/Users/geoaeiou/Desktop/spectrum/api/queries/communitySlackSettings/invitesSentAt.js", "JavaScript", 9, 0, 1, 2, 12
"/Users/geoaeiou/Desktop/spectrum/api/queries/communitySlackSettings/isConnected.js", "JavaScript", 9, 0, 1, 2, 12
"/Users/geoaeiou/Desktop/spectrum/api/queries/communitySlackSettings/memberCount.js", "JavaScript", 9, 0, 1, 2, 12
"/Users/geoaeiou/Desktop/spectrum/api/queries/communitySlackSettings/slackChannelList.js", "JavaScript", 18, 0, 1, 4, 23
"/Users/geoaeiou/Desktop/spectrum/api/queries/communitySlackSettings/teamName.js", "JavaScript", 12, 0, 1, 2, 15
"/Users/geoaeiou/Desktop/spectrum/api/queries/directMessageThread/index.js", "JavaScript", 16, 0, 1, 2, 19
"/Users/geoaeiou/Desktop/spectrum/api/queries/directMessageThread/messageConnection.js", "JavaScript", 29, 0, 9, 5, 43
"/Users/geoaeiou/Desktop/spectrum/api/queries/directMessageThread/participants.js", "JavaScript", 15, 0, 1, 5, 21
"/Users/geoaeiou/Desktop/spectrum/api/queries/directMessageThread/rootDirectMessageThread.js", "JavaScript", 12, 0, 2, 5, 19
"/Users/geoaeiou/Desktop/spectrum/api/queries/directMessageThread/rootDirectMessageThreadByUserIds.js", "JavaScript", 14, 0, 2, 6, 22
"/Users/geoaeiou/Desktop/spectrum/api/queries/directMessageThread/snippet.js", "JavaScript", 20, 0, 1, 5, 26
"/Users/geoaeiou/Desktop/spectrum/api/queries/message/author.js", "JavaScript", 46, 0, 3, 9, 58
"/Users/geoaeiou/Desktop/spectrum/api/queries/message/content.js", "JavaScript", 7, 0, 1, 2, 10
"/Users/geoaeiou/Desktop/spectrum/api/queries/message/index.js", "JavaScript", 22, 0, 1, 2, 25
"/Users/geoaeiou/Desktop/spectrum/api/queries/message/parent.js", "JavaScript", 10, 0, 1, 2, 13
"/Users/geoaeiou/Desktop/spectrum/api/queries/message/reactions.js", "JavaScript", 17, 0, 1, 2, 20
"/Users/geoaeiou/Desktop/spectrum/api/queries/message/rootGetMediaMessagesForThread.js", "JavaScript", 3, 0, 1, 2, 6
"/Users/geoaeiou/Desktop/spectrum/api/queries/message/rootMessage.js", "JavaScript", 4, 0, 1, 2, 7
"/Users/geoaeiou/Desktop/spectrum/api/queries/message/sender.js", "JavaScript", 30, 0, 8, 6, 44
"/Users/geoaeiou/Desktop/spectrum/api/queries/message/thread.js", "JavaScript", 3, 0, 1, 2, 6
"/Users/geoaeiou/Desktop/spectrum/api/queries/meta/channelsGrowth.js", "JavaScript", 12, 0, 1, 3, 16
"/Users/geoaeiou/Desktop/spectrum/api/queries/meta/communitiesGrowth.js", "JavaScript", 12, 0, 1, 3, 16
"/Users/geoaeiou/Desktop/spectrum/api/queries/meta/coreMetrics.js", "JavaScript", 7, 0, 1, 2, 10
"/Users/geoaeiou/Desktop/spectrum/api/queries/meta/directMessageThreadsGrowth.js", "JavaScript", 24, 0, 1, 3, 28
"/Users/geoaeiou/Desktop/spectrum/api/queries/meta/directMessagesGrowth.js", "JavaScript", 20, 0, 1, 3, 24
"/Users/geoaeiou/Desktop/spectrum/api/queries/meta/index.js", "JavaScript", 27, 0, 1, 2, 30
"/Users/geoaeiou/Desktop/spectrum/api/queries/meta/isAdmin.js", "JavaScript", 6, 0, 1, 2, 9
"/Users/geoaeiou/Desktop/spectrum/api/queries/meta/threadMessagesGrowth.js", "JavaScript", 20, 0, 1, 3, 24
"/Users/geoaeiou/Desktop/spectrum/api/queries/meta/threadsGrowth.js", "JavaScript", 12, 0, 1, 3, 16
"/Users/geoaeiou/Desktop/spectrum/api/queries/meta/topThreads.js", "JavaScript", 23, 0, 1, 7, 31
"/Users/geoaeiou/Desktop/spectrum/api/queries/meta/usersGrowth.js", "JavaScript", 15, 0, 1, 3, 19
"/Users/geoaeiou/Desktop/spectrum/api/queries/notification/directMessageNotifications.js", "JavaScript", 23, 0, 3, 2, 28
"/Users/geoaeiou/Desktop/spectrum/api/queries/notification/index.js", "JavaScript", 10, 0, 1, 2, 13
"/Users/geoaeiou/Desktop/spectrum/api/queries/notification/notification.js", "JavaScript", 3, 0, 1, 2, 6
"/Users/geoaeiou/Desktop/spectrum/api/queries/notification/notifications.js", "JavaScript", 24, 0, 2, 3, 29
"/Users/geoaeiou/Desktop/spectrum/api/queries/reaction/index.js", "JavaScript", 12, 0, 1, 2, 15
"/Users/geoaeiou/Desktop/spectrum/api/queries/reaction/message.js", "JavaScript", 3, 0, 1, 2, 6
"/Users/geoaeiou/Desktop/spectrum/api/queries/reaction/reaction.js", "JavaScript", 2, 0, 1, 1, 4
"/Users/geoaeiou/Desktop/spectrum/api/queries/reaction/user.js", "JavaScript", 4, 0, 1, 2, 7
"/Users/geoaeiou/Desktop/spectrum/api/queries/search/index.js", "JavaScript", 27, 0, 2, 4, 33
"/Users/geoaeiou/Desktop/spectrum/api/queries/search/search.js", "JavaScript", 41, 0, 1, 3, 45
"/Users/geoaeiou/Desktop/spectrum/api/queries/search/searchCommunities.js", "JavaScript", 19, 0, 1, 3, 23
"/Users/geoaeiou/Desktop/spectrum/api/queries/search/searchCommunityMembers.js", "JavaScript", 30, 0, 5, 4, 39
"/Users/geoaeiou/Desktop/spectrum/api/queries/search/searchResultsConnection.js", "JavaScript", 16, 0, 1, 2, 19
"/Users/geoaeiou/Desktop/spectrum/api/queries/search/searchThreads.js", "JavaScript", 260, 0, 20, 59, 339
"/Users/geoaeiou/Desktop/spectrum/api/queries/search/searchUsers.js", "JavaScript", 20, 0, 2, 5, 27
"/Users/geoaeiou/Desktop/spectrum/api/queries/search/types.js", "JavaScript", 13, 0, 1, 2, 16
"/Users/geoaeiou/Desktop/spectrum/api/queries/thread/attachments.js", "JavaScript", 2, 0, 6, 2, 10
"/Users/geoaeiou/Desktop/spectrum/api/queries/thread/author.js", "JavaScript", 40, 0, 1, 6, 47
"/Users/geoaeiou/Desktop/spectrum/api/queries/thread/channel.js", "JavaScript", 15, 0, 1, 2, 18
"/Users/geoaeiou/Desktop/spectrum/api/queries/thread/community.js", "JavaScript", 15, 0, 1, 2, 18
"/Users/geoaeiou/Desktop/spectrum/api/queries/thread/content.js", "JavaScript", 10, 0, 1, 2, 13
"/Users/geoaeiou/Desktop/spectrum/api/queries/thread/creator.js", "JavaScript", 23, 0, 6, 4, 33
"/Users/geoaeiou/Desktop/spectrum/api/queries/thread/currentUserLastSeen.js", "JavaScript", 17, 0, 1, 4, 22
"/Users/geoaeiou/Desktop/spectrum/api/queries/thread/editedBy.js", "JavaScript", 41, 0, 1, 6, 48
"/Users/geoaeiou/Desktop/spectrum/api/queries/thread/index.js", "JavaScript", 42, 0, 1, 4, 47
"/Users/geoaeiou/Desktop/spectrum/api/queries/thread/isAuthor.js", "JavaScript", 6, 0, 1, 2, 9
"/Users/geoaeiou/Desktop/spectrum/api/queries/thread/isCreator.js", "JavaScript", 6, 0, 6, 2, 14
"/Users/geoaeiou/Desktop/spectrum/api/queries/thread/messageConnection.js", "JavaScript", 94, 0, 19, 10, 123
"/Users/geoaeiou/Desktop/spectrum/api/queries/thread/metaImage.js", "JavaScript", 18, 0, 1, 6, 25
"/Users/geoaeiou/Desktop/spectrum/api/queries/thread/participants.js", "JavaScript", 7, 0, 1, 2, 10
"/Users/geoaeiou/Desktop/spectrum/api/queries/thread/reactions.js", "JavaScript", 28, 0, 1, 8, 37
"/Users/geoaeiou/Desktop/spectrum/api/queries/thread/receiveNotifications.js", "JavaScript", 16, 0, 1, 2, 19
"/Users/geoaeiou/Desktop/spectrum/api/queries/thread/rootSearchThreads.js", "JavaScript", 196, 0, 33, 41, 270
"/Users/geoaeiou/Desktop/spectrum/api/queries/thread/rootThread.js", "JavaScript", 25, 0, 3, 5, 33
"/Users/geoaeiou/Desktop/spectrum/api/queries/user/channelConnection.js", "JavaScript", 12, 0, 1, 2, 15
"/Users/geoaeiou/Desktop/spectrum/api/queries/user/communityConnection.js", "JavaScript", 44, 0, 1, 5, 50
"/Users/geoaeiou/Desktop/spectrum/api/queries/user/contextPermissions.js", "JavaScript", 117, 0, 8, 3, 128
"/Users/geoaeiou/Desktop/spectrum/api/queries/user/coverPhoto.js", "JavaScript", 7, 0, 1, 2, 10
"/Users/geoaeiou/Desktop/spectrum/api/queries/user/directMessageThreadsConnection.js", "JavaScript", 27, 0, 2, 4, 33
"/Users/geoaeiou/Desktop/spectrum/api/queries/user/email.js", "JavaScript", 12, 0, 2, 2, 16
"/Users/geoaeiou/Desktop/spectrum/api/queries/user/everything.js", "JavaScript", 28, 0, 3, 2, 33
"/Users/geoaeiou/Desktop/spectrum/api/queries/user/githubProfile.js", "JavaScript", 8, 0, 1, 2, 11
"/Users/geoaeiou/Desktop/spectrum/api/queries/user/index.js", "JavaScript", 49, 0, 2, 4, 55
"/Users/geoaeiou/Desktop/spectrum/api/queries/user/isAdmin.js", "JavaScript", 3, 0, 1, 2, 6
"/Users/geoaeiou/Desktop/spectrum/api/queries/user/isOnline.js", "JavaScript", 4, 0, 2, 2, 8
"/Users/geoaeiou/Desktop/spectrum/api/queries/user/profilePhoto.js", "JavaScript", 7, 0, 1, 2, 10
"/Users/geoaeiou/Desktop/spectrum/api/queries/user/rootCurrentUser.js", "JavaScript", 8, 0, 1, 2, 11
"/Users/geoaeiou/Desktop/spectrum/api/queries/user/rootSearchUsers.js", "JavaScript", 19, 0, 6, 2, 27
"/Users/geoaeiou/Desktop/spectrum/api/queries/user/rootUser.js", "JavaScript", 10, 0, 1, 2, 13
"/Users/geoaeiou/Desktop/spectrum/api/queries/user/settings.js", "JavaScript", 13, 0, 1, 2, 16
"/Users/geoaeiou/Desktop/spectrum/api/queries/user/threadConnection.js", "JavaScript", 59, 0, 4, 4, 67
"/Users/geoaeiou/Desktop/spectrum/api/queries/user/threadCount.js", "JavaScript", 5, 0, 1, 2, 8
"/Users/geoaeiou/Desktop/spectrum/api/queries/user/totalReputation.js", "JavaScript", 8, 0, 1, 2, 11
"/Users/geoaeiou/Desktop/spectrum/api/routes/api/email.js", "JavaScript", 202, 0, 17, 20, 239
"/Users/geoaeiou/Desktop/spectrum/api/routes/api/export-user-data.js", "JavaScript", 11, 0, 3, 5, 19
"/Users/geoaeiou/Desktop/spectrum/api/routes/api/index.js", "JavaScript", 9, 0, 8, 8, 25
"/Users/geoaeiou/Desktop/spectrum/api/routes/api/slackImporter.js", "JavaScript", 61, 0, 5, 10, 76
"/Users/geoaeiou/Desktop/spectrum/api/routes/auth/create-signin-routes.js", "JavaScript", 50, 0, 20, 7, 77
"/Users/geoaeiou/Desktop/spectrum/api/routes/auth/facebook.js", "JavaScript", 9, 0, 1, 5, 15
"/Users/geoaeiou/Desktop/spectrum/api/routes/auth/github.js", "JavaScript", 10, 0, 1, 5, 16
"/Users/geoaeiou/Desktop/spectrum/api/routes/auth/google.js", "JavaScript", 9, 0, 1, 5, 15
"/Users/geoaeiou/Desktop/spectrum/api/routes/auth/index.js", "JavaScript", 13, 0, 1, 4, 18
"/Users/geoaeiou/Desktop/spectrum/api/routes/auth/logout.js", "JavaScript", 11, 0, 0, 4, 15
"/Users/geoaeiou/Desktop/spectrum/api/routes/auth/twitter.js", "JavaScript", 7, 0, 1, 5, 13
"/Users/geoaeiou/Desktop/spectrum/api/routes/create-subscription-server.js", "JavaScript", 22, 0, 5, 4, 31
"/Users/geoaeiou/Desktop/spectrum/api/routes/middlewares/index.js", "JavaScript", 51, 0, 8, 17, 76
"/Users/geoaeiou/Desktop/spectrum/api/schema.js", "JavaScript", 158, 0, 9, 18, 185
"/Users/geoaeiou/Desktop/spectrum/api/subscriptions/community.js", "JavaScript", 53, 0, 4, 5, 62
"/Users/geoaeiou/Desktop/spectrum/api/subscriptions/directMessageThread.js", "JavaScript", 39, 0, 5, 5, 49
"/Users/geoaeiou/Desktop/spectrum/api/subscriptions/message.js", "JavaScript", 68, 0, 7, 8, 83
"/Users/geoaeiou/Desktop/spectrum/api/subscriptions/notification.js", "JavaScript", 64, 0, 3, 5, 72
"/Users/geoaeiou/Desktop/spectrum/api/subscriptions/thread.js", "JavaScript", 55, 0, 4, 5, 64
"/Users/geoaeiou/Desktop/spectrum/api/subscriptions/utils.js", "JavaScript", 25, 0, 3, 5, 33
"/Users/geoaeiou/Desktop/spectrum/api/test/channel/mutations/createChannel.test.js", "JavaScript", 129, 0, 2, 24, 155
"/Users/geoaeiou/Desktop/spectrum/api/test/channel/mutations/deleteChannel.test.js", "JavaScript", 203, 0, 2, 25, 230
"/Users/geoaeiou/Desktop/spectrum/api/test/channel/mutations/editChannel.test.js", "JavaScript", 78, 0, 2, 15, 95
"/Users/geoaeiou/Desktop/spectrum/api/test/channel/queries/blockedUsers.test.js", "JavaScript", 133, 0, 1, 20, 154
"/Users/geoaeiou/Desktop/spectrum/api/test/channel/queries/channelSettings.test.js", "JavaScript", 30, 0, 1, 5, 36
"/Users/geoaeiou/Desktop/spectrum/api/test/channel/queries/memberConnection.test.js", "JavaScript", 31, 0, 1, 4, 36
"/Users/geoaeiou/Desktop/spectrum/api/test/channel/queries/pendingUsers.test.js", "JavaScript", 133, 0, 1, 20, 154
"/Users/geoaeiou/Desktop/spectrum/api/test/channel/queries/root.test.js", "JavaScript", 36, 0, 1, 7, 44
"/Users/geoaeiou/Desktop/spectrum/api/test/channel/queries/slackSettings.test.js", "JavaScript", 108, 0, 1, 20, 129
"/Users/geoaeiou/Desktop/spectrum/api/test/community.test.js", "JavaScript", 86, 0, 1, 13, 100
"/Users/geoaeiou/Desktop/spectrum/api/test/community/mutations/createCommunity.test.js", "JavaScript", 90, 0, 2, 22, 114
"/Users/geoaeiou/Desktop/spectrum/api/test/community/mutations/editCommunity.test.js", "JavaScript", 68, 0, 2, 15, 85
"/Users/geoaeiou/Desktop/spectrum/api/test/community/mutations/toggleCommunityMembership.test.js", "JavaScript", 238, 0, 3, 33, 274
"/Users/geoaeiou/Desktop/spectrum/api/test/community/queries/communitySettings.test.js", "JavaScript", 20, 0, 1, 5, 26
"/Users/geoaeiou/Desktop/spectrum/api/test/community/queries/slackSettings.test.js", "JavaScript", 118, 0, 1, 20, 139
"/Users/geoaeiou/Desktop/spectrum/api/test/directMessageThread.test.js", "JavaScript", 133, 0, 6, 22, 161
"/Users/geoaeiou/Desktop/spectrum/api/test/message/mutations/addMessage.test.js", "JavaScript", 110, 0, 4, 12, 126
"/Users/geoaeiou/Desktop/spectrum/api/test/message/queries.test.js", "JavaScript", 38, 0, 1, 6, 45
"/Users/geoaeiou/Desktop/spectrum/api/test/thread/mutations/deleteThread.test.js", "JavaScript", 79, 0, 2, 21, 102
"/Users/geoaeiou/Desktop/spectrum/api/test/thread/mutations/publishThread.test.js", "JavaScript", 82, 0, 2, 15, 99
"/Users/geoaeiou/Desktop/spectrum/api/test/thread/queries/messageConnection.test.js", "JavaScript", 195, 0, 13, 30, 238
"/Users/geoaeiou/Desktop/spectrum/api/test/thread/queries/reversePagination.test.js", "JavaScript", 162, 0, 15, 26, 203
"/Users/geoaeiou/Desktop/spectrum/api/test/thread/queries/root.test.js", "JavaScript", 22, 0, 1, 4, 27
"/Users/geoaeiou/Desktop/spectrum/api/test/user.test.js", "JavaScript", 137, 0, 1, 18, 156
"/Users/geoaeiou/Desktop/spectrum/api/test/utils.js", "JavaScript", 21, 0, 2, 3, 26
"/Users/geoaeiou/Desktop/spectrum/api/test/utils/__mocks__/debug.js", "JavaScript", 11, 0, 1, 4, 16
"/Users/geoaeiou/Desktop/spectrum/api/test/utils/create-graphql-error-formatter.test.js", "JavaScript", 85, 0, 1, 21, 107
"/Users/geoaeiou/Desktop/spectrum/api/types/Channel.js", "JavaScript", 122, 0, 1, 21, 144
"/Users/geoaeiou/Desktop/spectrum/api/types/ChannelSlackSettings.js", "JavaScript", 20, 0, 1, 6, 27
"/Users/geoaeiou/Desktop/spectrum/api/types/Community.js", "JavaScript", 318, 0, 1, 53, 372
"/Users/geoaeiou/Desktop/spectrum/api/types/CommunityMember.js", "JavaScript", 85, 0, 1, 16, 102
"/Users/geoaeiou/Desktop/spectrum/api/types/CommunitySlackSettings.js", "JavaScript", 15, 0, 1, 3, 19
"/Users/geoaeiou/Desktop/spectrum/api/types/DirectMessageThread.js", "JavaScript", 62, 0, 1, 12, 75
"/Users/geoaeiou/Desktop/spectrum/api/types/Invoice.js", "JavaScript", 14, 0, 2, 3, 19
"/Users/geoaeiou/Desktop/spectrum/api/types/Message.js", "JavaScript", 61, 0, 1, 12, 74
"/Users/geoaeiou/Desktop/spectrum/api/types/Meta.js", "JavaScript", 58, 0, 1, 7, 66
"/Users/geoaeiou/Desktop/spectrum/api/types/Notification.js", "JavaScript", 75, 0, 1, 10, 86
"/Users/geoaeiou/Desktop/spectrum/api/types/Reaction.js", "JavaScript", 24, 0, 1, 6, 31
"/Users/geoaeiou/Desktop/spectrum/api/types/Search.js", "JavaScript", 45, 0, 1, 8, 54
"/Users/geoaeiou/Desktop/spectrum/api/types/Thread.js", "JavaScript", 127, 0, 1, 22, 150
"/Users/geoaeiou/Desktop/spectrum/api/types/ThreadParticipant.js", "JavaScript", 13, 0, 1, 2, 16
"/Users/geoaeiou/Desktop/spectrum/api/types/User.js", "JavaScript", 162, 0, 1, 33, 196
"/Users/geoaeiou/Desktop/spectrum/api/types/custom-scalars/LowercaseString.js", "JavaScript", 19, 0, 2, 3, 24
"/Users/geoaeiou/Desktop/spectrum/api/types/general.js", "JavaScript", 82, 0, 4, 15, 101
"/Users/geoaeiou/Desktop/spectrum/api/types/scalars.js", "JavaScript", 17, 0, 6, 4, 27
"/Users/geoaeiou/Desktop/spectrum/api/utils/UserError.js", "JavaScript", 11, 0, 1, 4, 16
"/Users/geoaeiou/Desktop/spectrum/api/utils/asyncify.js", "JavaScript", 57, 0, 2, 8, 67
"/Users/geoaeiou/Desktop/spectrum/api/utils/base64.js", "JavaScript", 5, 0, 11, 3, 19
"/Users/geoaeiou/Desktop/spectrum/api/utils/create-graphql-error-formatter.js", "JavaScript", 63, 0, 2, 10, 75
"/Users/geoaeiou/Desktop/spectrum/api/utils/file-storage.js", "JavaScript", 21, 0, 1, 6, 28
"/Users/geoaeiou/Desktop/spectrum/api/utils/file-system.js", "JavaScript", 32, 0, 1, 8, 41
"/Users/geoaeiou/Desktop/spectrum/api/utils/generate-thread-meta-image-from-text.js", "JavaScript", 59, 0, 6, 14, 79
"/Users/geoaeiou/Desktop/spectrum/api/utils/get-page-meta.js", "JavaScript", 144, 0, 14, 7, 165
"/Users/geoaeiou/Desktop/spectrum/api/utils/get-random-default-photo.js", "JavaScript", 20, 0, 2, 2, 24
"/Users/geoaeiou/Desktop/spectrum/api/utils/is-spectrum-url.js", "JavaScript", 22, 0, 8, 4, 34
"/Users/geoaeiou/Desktop/spectrum/api/utils/markdown-linkify.js", "JavaScript", 26, 0, 4, 4, 34
"/Users/geoaeiou/Desktop/spectrum/api/utils/paginate-arrays.js", "JavaScript", 22, 0, 6, 4, 32
"/Users/geoaeiou/Desktop/spectrum/api/utils/permissions.js", "JavaScript", 212, 0, 10, 59, 281
"/Users/geoaeiou/Desktop/spectrum/api/utils/rate-limit-directive.js", "JavaScript", 13, 0, 1, 2, 16
"/Users/geoaeiou/Desktop/spectrum/api/utils/s3.js", "JavaScript", 60, 0, 5, 9, 74
"/Users/geoaeiou/Desktop/spectrum/api/utils/session-store.js", "JavaScript", 23, 0, 7, 6, 36
"/Users/geoaeiou/Desktop/spectrum/api/utils/validate-draft-js-input.js", "JavaScript", 11, 0, 1, 2, 14
"Total", "-", 23866, 142, 1614, 3266, 28888